0010
0010
X0X0X0X0X0
XXXXXXXXXX
XX0XX0XX0X
0X0X0X0X0X
XXXXXXXXXX
X00000000X
X000XX000X
X000XX000X
X00000000X
XXXXXXXXXX
