0010
0010
0001
0005
none
1_2
#.#.#.#.#.
##########
##.##.##.#
.#.#.#.#.#
##########
#........#
#...##...#
#...##...#
#.......E#
##########
