0011
0010
0001
0001
1_1.txt
1_final.txt
##########
#..$$....#
#&&&&&&&.#
#.....$..#
#.&&&&&&&#
#..%.....#
#&&&&&&&.#
#........#
#.&&&&&&&#
#.......E#
##########