0021
0016
0000
0001
#...#..##..#..#.
.#.#..#..#.#..#.
..#...#..#.#..#.
..#....##...##..
................
#...............
#...............
##...##.#.#..##.
#.#.#.#.#.#.#.#.
#.#..##..#...###
................
..............#.
..............#.
#.#.#..#..##..#.
#.#.#.#.#.#.#...
.#.#...#..#.#.#.
Congratulations!
...You.have.....
..successfully..
.completed.the..
first.levelset!!